0000000000000000000000000
0111111111111111111111110
0111111111111111111111110
0000000000000000000000000
0000000000000000000000000
0110011001110010010010000
0101010101000101010100000
0110011001100111011000000
0101010101000101010100000
0110010101110101010010000
0000000000000000000000000
0000000000011101010111010
0000000000010101010010010
0000000000010101010010010
0000000000010101010010000
0000000000011101110010010
0000000000000000000000000
0000000000000000000000000
0000000000000000000000000
0000000000000000000000000
0000000000000000000000000
0000000000000000000000000
0111111111111111111111110
0111111111111111111111110
0000000000000000000000000
