0000000000000000000000000
0110000000000000000000000
0110000000000000000000000
0000000100001000000000000
0000000110011000000000000
0000000100001000000000000
0000000000000000001000000
0010000000000000010000000
0111000000000000100000000
0010000110000000000000000
0000000111100000000000000
0000000110000000000000000
0111100000000000000000000
0101000110000000000000000
0000011110000011100000000
0000000110000011100000000
0000000000000011100000000
0111000000000000000000000
0101000000000000000000000
0111000000000010000101011
0000000000000000000000000
0000000000000000000000000
0000000000000000000000000
0000000000000000000000000
0000000000000000000000000